#########################################################
#              #                             #          #
#              #                             #          #
#              #                             #          #
#              #                             #          #
#              #                             #          #
#                . .. . . . .                #          #
#  . . . . . .                                          #
#                                                       #
#                                                       #
################                                        #
#                                      #       # # # #  #
#                            #         #                #
#                            #         #                #
#             . . .. .       #         #                #
#########################################################